1 13 31
###############################
#p      3b   * *   *  * * *   #
#      *    #*#*# # # #*#*#*# #
#? x 4    ***  *      *   * * #
# # # # # #*# # #*#*# # # # #*#
#    w     x **  *  *         #
# # # # # # # # # #*# #*# # # #
#*  *      *  *      *        #
# # # # #*# # # #*#*# # # # # #
#*    **  *       *           #
# #*# # # # # # #*# # # # # # #
#           *   *  *          #
###############################