0 13 31
###############################
#p   t  3b   * *   *  * * *   #
#   f  *    #*#*# # # #*#*#*# #
#? x      ***  *      *   * * #
# # # # # #*# # #*#*# # # # #*#
#    w     x **  *  *     t   #
# # # # # # # # # #*# #*# # # #
#*  *      *  *      *        #
# # # # #*# # # #*#*# # # # # #
#*    **  *       *       ^   #
# #*# # # # # # #*# # # # # # #
#           * ^ *  *          #
###############################