0 13 31
###############################
#p   t  3b   * *   *  * * *   #
#   b  *    #*#*# # # #*#*#*# #
#? x      ***  *      *   * * #
# # # # # #*# # #*#*# # # # #*#
#    w     x **  *  *         #
# # # # # # # # # #*# #*# # # #
#*  *      *  *      *        #
# # # # #*# # # #*#*# # # # # #
#*    **  *       *           #
# #*# # # # # # #*# # # # # # #
#           *   *  *          #
###############################