1 13 31
###############################
#p  b   * *    *   *  * * *   #
# # # #*# # #*#*# # # #*#*#*# #
#? x      ***  *      *   * * #
# # # # # #*# # #*#*# # # # #*#
#    w     x **  *  *         #
# # # # # # # # # #*# #*# # # #
#*  *      *  *      *        #
# # # # #*# # # #*#*# # # # # #
#*    **  *       *           #
# #*# # # # # # #*# # # # # # #
#           *   *  *          #
###############################