0 13 31
###############################
#p   w  3b   * *   *  * * *   #
#  b   *    #*#*# # # #*#*#*# #
#? x 1    ***  *      *   * * #
# # # # # #*# # #*#*# # # # #*#
#    w     x **  *  *         #
# # # # # # # # # #*# #*# # # #
#*  *      *  *      *        #
# # # # #*# # # #*#*# # # # # #
#*    **  *       *           #
# #*# # # # # # #*# # # # # # #
#           *   *  *          #
###############################